01000000000
01000000000
01000000000
01000000000
01000000000
01111111100
00000002000
